RLA = "countries/Luan.txt" #栾氏
FAN = "countries/Fan.txt" #范氏
CZH = "countries/ZhongHang.txt" #中行氏
ZHI = "countries/Zhi.txt" #智氏
YSG = "countries/Shang.txt"  #殷商
XIA = "countries/Xia.txt" #夏后
#戎狄国家
CDI = "countries/ChiDi.txt" #赤狄
XIY = "countries/XianYu.txt" #鲜虞
WUZ = "countries/WuZhong.txt" #无终
LOU = "countries/LouFan.txt" #楼烦 emmm
YQU = "countries/YiQu.txt" #义渠
YLR = "countries/YiLuo.txt" #伊洛戎
LHR = "countries/LuHun.txt" #陆浑戎
CMS = "countries/ManShi.txt" #蛮氏
WSH = "countries/WuShi.txt" #乌氏
#东夷
LAI = "countries/LaiYi.txt" #莱夷
HYI = "countries/HuaiYi.txt" #淮夷
ZWG = "countries/ZhongWu.txt" #钟吾
#诸侯
TGA = "countries/TangGuo.txt" #唐
SGO = "countries/SuiGuo.txt" #随
LIG = "countries/LiGuo.txt" #厉
XUG = "countries/XuGuo.txt" #许
HUG = "countries/HuGuo.txt" #胡
QIG = "countries/QiGuo.txt" #杞
SHG = "countries/ShenGuo.txt" #沈
#干越
YIH = "countries/YiHu.txt" #夷虎
CHG = "countries/ChaoGuo.txt" #巢
SJG = "countries/ShuJiu.txt" #舒鸠
LSH = "countries/LongShu.txt" #龙舒